....................
.....###########....
...............#....
...............#....
....................
....................
.....###########....
.........#..........
.........#..........
.........#..........
.........#..........
.........#..........
.........#..........
.........#..........
.........#..........
.....##########.....
....................
....................
....................
....................