....###.....###.....
...#...#...#...#....
..#.....###.....#...
...............#....
....#.........#.....
.....#.......#......
......#.....#.......
.......#............
........#.#.........
.........#..........
....###.....###.....
...#...#...#...#....
..#.....###.....#...
...#...........#....
....#...............
.....#.......#......
......#.....#.......
...........#........
........#.#.........
.........#..........
