....................
.....###########....
...............#....
.......#.......#....
.......#............
.......#............
.......#............
.......#............
.......#########....
....................
....................
...............#....
...............#....
...............#....
...............#....
..........######....
....................
....................
....................
....................