....................
....................
...............#....
...............#....
..........######....
...............#....
...............#....
....................
.......#############
...............#....
...............#....
...............#....
...............#....
...............#....
...............#....
..........######....
....................
....................
....................
....................