....................
....................
..........#....#....
..........#....#....
......##########....
......#........#....
.######........###..
......#........#....
...............#....
....................
..............####..
.......########.....
.......#............
.......#............
.......#............
.......#########....
...............#....
...............#....
.........#..#..#....
.........#######....