....................
.....###########....
...............#....
...............#....
....................
....................
....................
....................
....................
....................
....................
.........$.....#....
...............#....
...............#....
...............#....
..........#..###....
....................
....................
....................
#..................#